                                        
 #################                      
 #   #        #  #                      
 #   #        #  ##################     
 #   #        #            #      #     
 #   #        #            #      #     
 #   #######  #   ##########      #     
 ###       #  #            #      #     
 ####################      #      #     
 ######      #                    #     
 #           ##                   #    #
 #           #       #            #    #
 #           #       #            #    #
 #           #       #            #     
             #       #            #     
  ################   ###############    
          #     #            #######    
                #          #            
                ##########$             
                                        
