                                        
 #################                      
 #   #        #  #                      
 #   #   #    #  ##################     
 #   #   #    #            #      #     
 #   #   #    #            #      #     
 #   #######  #   ##########      #     
 #         #  #            ####   #     
 ####################      #      #     
 #   #       #          ####      #     
 #   #       #             #      #     
 #   #       #   #####     ####   #     
 #   #       #       #     #      #     
 #   #  ######       #     #      #     
     #       #       #            #     
  ################   ###############    
                #                  #    
                #            #######    
                ##########$             
                                        
